11111111111111
1000P0000X10E1
10011111011001
11001111111011
110000000C0011
111C1100001111
11111111111111