11111111111111111111111111111111111111111111111111
10000000000111110000000000000000001111100000000001
10111111000100010011111111111000001000100011111001
1010000100010001001000000000100000100010P010001001
10101101000101110010111111101000001011100010101001
10101001000000000010100000101000001000000010001001
10101001111111110010101110101111101111111011111001
10101000000000010010001000100000100000001000001001
10101111111011110010001000101111101111001011101001
10100X00001010000010001000100000100001001000001001
10111111001010111110101110101110101110101111111001
10000001001010000010100000101000100001000000000001
11111001001011111010101111101011101110111111111101
10001000001000001000001000100000100000000000000001
10101011101011101011101010101110101111111111111001
10100010001000000000101010000010000000000000001001
10101110101111111010101010111110101111111111001001
10100000100000001010101010000000100000000001001001
10111111111111001010101010111111111111101011001001
10000000000001000000001010000000C00000101000001001
11111111111001111111001010111111111110101111101001
10000000001000000000001010000000000010100000101001
10111111001111111111001010111111111010111110101001
10100000000000000000001010000000001000000000101001
10101111111111111111001010111111101111111110111001
10101000000000000000001010000000100000000000001001
10101011111111111111001010111110101111111111001001
10101010000000000000001010001000100000000001001001
10101010111111111111001010101110111111111111001001
101000000000C0000000001010000000000000000000001001
10101111111111111111001011111111111111111111111001
10001000000000000000001000000000000000000000000001
10111011111111111111001111111111111111111111111101
10000010000000000000001000000000000C00000000000001
10111110111111111111101011111111111111111111111101
10100000100000000000100000000000000000000000000001
10101110101111111110111111111111111111111111111101
101000E0101000000000100000000000000000000000000001
10101111101111111110101111111111111111111111111101
10100000000000000000001000000000000000000000000001
10111111111111111111101111111111111111111111111101
1000000000000000000000000000000000X000000000000001
11111111111111111111111111111111111111111111111111