11111111111111111111111111111111
10P000000C0000000000000000000001
10111011111111111111111111111001
10001010000010000001010000001001
10101010111011101110101010101001
10001010000000000000001010000001
10111011111111111111111111111001
10000000000010000000000000000001
10111111110111011111011111011001
10000000010000000000000000000001
11101111011111011110111110111011
1000000000C00000000000E000000101
10101010101111011110111010101101
100000000000X00000C0000000000101
11111111111111111111111111111111