1111111111
1P111C1E11
1111111111
1111111111
1111111111