1111111111
1P000C0E01
1000000111
10000001C1
1111111111