1111111111
1P000C0001
1000000001
1000000001
1111111111