1111111111
1P000C1E01
1000001111
1000000001
1111111111