1111111111
10000C0E01
1000000001
1000000001
1111111111