11111111111
1P000C0E001
10000000001
10000000001
10000000001
11110001111
   10001
   10001
   11111