1111111111
1P000C0E01
1000000001
100P000001
1111111111