1111111111
1P00000E01
1000000001
1000000001
1111111111