11111111111111
100000P00010E1
10011111C11001
11001111111011
11000000000011
111C1100001111
11111111111111